F 65,25,100
C 210,240,255

NO textures/11.png
SO textures/22.png
WE textures/33.png
EA textures/44.png

1111111111111111111111111111111111111
1000000000000000000000S00000000000001
1000000000000000000000000000000000001
1000000000000000000000000000000000001
1000000000000000000000000000000000001
1000000000000000000000000000000000001
1000000000000000000000000000000000001
1000000000000000000000000000000000001
1000111110001111100011111000111110001
11D1111111D1111111D1111111D1111111D11
1000111110001111100011111000111110001
1000000000000000000000000000000000001
1000000000000000000000000000000000001
1000000000000000000000000000000000001
1000000000000000000000000000000000001
1000000000000000000000000000000000001
1111111111111111111111111111111111111