F 15,     27,1
C 123,123,123

NO textures/scene1/1.png
SO textures/scene1/2.png
WE textures/scene1/3.png
EA textures/scene1/4.png

1111101111111111111
10W1001001001000001
1011000001000001001
1D110011D1111101111
1001111000001001001
1000000000000001001
10011111D1111001001
1111000000000001011
1000000001000000001
1111111111111111111