F 160, 50, 50
C 250,240,200

NO textures/scene1/1.png
SO textures/scene1/2.png
WE textures/scene1/3.png
EA textures/scene1/4.png

1111111111111111111
1W00000000000000001
1110111111111011101
10000D00000000D0001
1111111111111111101
1000000000000000001
1D111111111111111D1
1000000000000000001
1010111111111011101
1000000000000000001
1111111111111111111