F 95,158,160
C 200,255,200

NO textures/11.png
SO textures/22.png
WE textures/33.png
EA textures/44.png

1111111111111111111
1S00000000100000001
1011111111010111101
1D00000010001000001
1010111111111101111
1000100000000100001
1011101011111110111
1000001000000010001
1011101111101111101
1000000000000000001
1111111111111111111