NO       textures/scene1/1.png   
SO textures/scene1/2.png
WE textures/scene1/3.png
EA textures/scene1/4.png   

F    205,    45,249          
C 223,239,251

111111111111111111111111111   
1001001001001000001000001    
1001000010000010000000101 
10W10010011111011110000001
1001111000001001001000001
1000000000000001001111111 
1001111111110001001                                            
1111000000000001011000001111111
1000000001000000001000001010001
111111111111111111111111111111111