NO textures/scene2/1.png
SO textures/scene2/2.png
WE textures/scene2/3.png
EA textures/scene2/4.png

F 255,245,249
C 223,239,251

1111111111111111111
1001001001001000001
101100W001000001001
1001001001111101111
1001111000001001001
1000000000000001001
1001111111111001001
1111000000000001011
1000000001000000001
1111111111111111111