F 7,10,16
C 250,0,0

NO textures/scene1/1.png
SO textures/scene1/2.png
WE textures/scene1/3.png
EA textures/scene1/4.png

111111111111111111111111111111111111
100000000000000111000000000000000001
100000000000000000000000000000000001
100000000N00000011000000000000000001
100000110010000000000000000000000001
100100100110000000000000000000000001
100000000000000111000000000000000001
100000000000000001000000000000000001
100000000000000111000000000000000001
100000000000000000000000000000000001
100000000000000111000000000000000001
100000000000000000000000000000000001
100000000000000011000000000000000001
100000110010000000000000000000000001
100100100110000000000000000000000001
100000000000000111000000000000000001
100000000000000001000000000000000001
100000000000000111000000000000000001
100000000000000000000000000000000001
100000000000000111000000000000000001
100000000000000000000000000000000001
100000000000000011000000000000000001
100000110010000000000000000000000001
100100100110000000000000000000000001
100000000000000111000000000000000001
100000000000000001000000000000000001
100000000000000111000000000000000001
100000000000000000000000000000000001
100000000000000111000000000000000001
100000000000000000000000000000000001
100000000000000011000000000000000001
100000110010000000000000000000000001
100100100110000000000000000000000001
100000000000000111000000000000000001
100000000000000001000000000000000001
100000000000000111000000000000000001
100000000000000000000000000000000001
111111111111111111111111111111111111