F 80,120,160
C 220,220,220

NO textures/scene3/1.png
SO textures/scene3/2.png
WE textures/scene3/3.png
EA textures/scene3/4.png

1111111111111111111
1N00000000100000001
1011110111110111101
1010000001000100001
1010111111111101111
1000100000000100001
1111101011111110111
1000001000000010001
1011101111101111101
1000000000000000001
1111111111111111111