F 55,55,100
C 240,240,255

NO textures/11.png
SO textures/22.png
WE textures/33.png
EA textures/44.png

1111111111111111111
1E00000000000000001
1000000000000000001
1000000000000000001
1000111111111110001
1000100000000100001
1001110000000000111
1000000000000000001
1111111111111111111