F 60,60,60
C 200,200,200

NO textures/scene1/1.png
SO textures/scene1/2.png
WE textures/scene1/3.png
EA textures/scene1/4.png

111111111111111111111111111111111111111111111111111111111111111111111111111111111111111111111111111111111111111111111111
100000000000000000000000000000000000000000000000000000000000000000000000000000000000000000000000000000000000000000000001
101111111011111111111111011111111101111111111111111111110111111111111111111111111111111111111111111111111111111111110101
100000001010000000000001000000001000000000000000000000E10000000000000000000000000000000000000000000000000000000000010101
101111101010111111111101011111101011111111111111111110010111111111111111111111111111111111111111111111111111111110010101
101000101010100000001000010000001010000000000000000010010000000000000000000000000000000000000000000000000000000010010101
101011101110101111101110111111101110111111111111101010011111111111111111111111111111111111111111111111111111101010010101
100010000010100000101000000000000000000000000000001010000000000000000000000000000000000000000000000000000000001010000001
111011111010111110101011111111111111111111111111101011111111111111111111111111111111111111111111111111111111101011111101
100010000010000010001000000000000000000000000001001000000000000000000000000000000000000000000000000000000000001000000001
101110111111110111111111111111111111111111111101111011111111111111111111111111111111111111111111111111111111111011111111
100000100000000000000000000000000000000000000000000000000000000000000000000000000000000000000000000000000000000000000001
101110101111111111111111111111111111111111111111111111111111111111111111111111111111111111111111111111111111111111110101
100000101000000000000000000000000000000000000000000000000000000000000000000000000000000000000000000000000000000000010101
101111101011111111111111111111111111111111111111111111111111111111111111111111111111111111111111111111111111111110010101
100000001000000000000000000000000000000000000000000000000000000000000000000000000000000000000000000000000000000000010101
101111111111111111111111111111111111111111111111111111111111111111111111111111111111111111111111111111111111111111110101
100000000000000000000000000000000000000000000000000000000000000000000000000000000000000000000000000000000000000000000001
111111111111111111111111111111111111111111111111111111111111111111111111111111111111111111111111111111111111111111111111
