F 60,60,60
C 200,200,200

NO textures/scene1/1.png
SO textures/scene1/2.png
WE textures/scene1/3.png
EA textures/scene1/4.png

11111
10101
10101
10101
10101
10101
10101
10101
10101
10101
10101
10101
10101
10101
10101
10101
10101
10101
10101
10101
10101
10101
10101
10101
10101
10101
10101
10101
10101
10101
10101
10101
10101
10101
10101
10101
10101
10101
10101
10101
10101
10101
10101
10101
10101
10101
10101
10101
10101
10101
10101
10101
10101
10101
10101
10101
10101
10101
10101
10101
10101
10101
10101
10101
10101
10101
10101
10101
10101
10101
10101
1N001
11111