F 60,60,60
C 200,200,200

NO textures/scene1/1.png
SO textures/scene1/2.png
WE textures/scene1/3.png
EA textures/scene1/4.png

11111
10101
10101
10101
10101        1111                            111  111                                                                                
101111111111110111111111111111111111111111111101111011111111111111111111111111111111111111111111111111111111111111111111
10W000100000000000000000000000000000000000000000000000000000000000000000000000000000000000000000000000000000000000000001
101110101111111111111111111111111111111111111111111111111111111111111111111111111111111111111111111111111111111111110101
100000101000000000000000000000000000000000000000000000000000000000000000000000000000000000000000000000000000000000010101
101111101011111111111111111111111111111111111111111111111111111111111111111111111111111111111111111111111111111110010101
100000001000000000000000000000000000000000000000000000000000000000000000000000000000000000000000000000000000000000010101
101111111111111111111111111111111111111111111111111111111111111111111111111111111111111111111111111111111111111111110101
100000000000000000000000000000000000000000000000000000000000000000000000000000000000000000000000000000000000000000000001
111111111111111111111111111111111111111111111111111111111111111111111111111111111111111111111111111111111111111111111111

