F 25,25,29
C 23,29,21

NO textures/11.png
SO textures/22.png
WE textures/33.png
EA textures/44.png

1111111111111111111
1DW1DD1001001000001
1DDDDDD001000001001
1D110011D11111D1111
1001111000001001001
1000000000000001001
10011111D1111001001
1111000000000001011
1000000001000000001
1111111111111111111