NO textures/scene2/1.png
SO textures/scene2/2.png
F 223,239,251
C 223,239,251
WE textures/scene2/3.png
EA textures/scene2/4.png

111111111111111111111111111   
1001001001001000001000001    
1000000100000100000001011 
10010010011111011110000001          
1001111000001001001000001        
100000000000000100111111        
1001111111110001001                                            
1111000000000001011000001111111
1000011111000000001000001010001
11011    1111111111111111111111111111
 101          
 101      
 1011     
110001
  1E1          
 1001          
 101               
1001
101  1
101111111111111111111111111   
1001001001001000001000001    
1001010010000010000000101 
10010010011111011110000001          
1001111000001001001000001        
1000000000000001001111111        
1001111111110001001                                            
1111000000000001011000001111111
1000011111000000001000001010001
11111    1111111111111111111111111111